118 75
0 536 54 3 67 1 1 66 1 1 73 1 1
1 56 642 3 2 1 1 12 1 1 63 1 1
2 104 642 3 1 1 1 22 1 1 44 1 1
3 234 642 3 22 1 1 4 1 1 24 1 1
4 332 642 3 3 1 1 26 1 0 69 1 1
5 536 642 4 26 1 1 71 1 1 72 1 1 48 1 1
6 750 642 4 28 1 1 72 1 1 29 1 1 53 1 1
7 972 642 4 29 1 1 32 1 1 61 1 1 60 1 1
8 1178 642 4 33 1 1 61 1 1 62 1 1 9 1 1
9 1372 642 2 8 1 1 10 1 1
10 1372 534 2 9 1 1 11 1 1
11 1430 534 3 10 1 1 66 1 1 65 1 1
12 56 328 3 1 1 1 21 1 1 68 1 1
13 158 328 3 36 1 1 21 1 1 14 1 1
14 234 328 3 13 1 1 37 1 1 23 1 1
15 332 328 3 37 1 1 39 1 1 25 1 1
16 536 328 4 40 1 1 39 1 1 17 1 1 27 1 1
17 750 328 3 16 1 1 31 1 1 28 1 1
18 972 328 3 19 1 1 43 1 1 32 1 1
19 972 214 2 18 1 1 20 1 1
20 1178 214 3 19 1 1 34 1 1 33 1 1
21 106 328 2 12 1 1 13 1 1
22 178 642 2 2 1 1 3 1 1
23 234 410 2 14 1 1 24 1 1
24 234 538 2 23 2 1 3 1 1
25 332 398 2 15 1 1 69 1 1
26 448 642 3 4 1 1 5 1 1 70 1 1
27 536 490 2 71 1 1 16 1 1
28 750 480 3 6 1 1 17 1 1 74 1 1
29 865 642 4 6 1 1 7 1 1 30 1 1 54 1 1
30 865 516 2 29 1 1 74 1 1
31 865 328 3 17 1 1 43 1 1 74 1 1
32 972 480 3 18 1 1 74 1 1 7 1 1
33 1178 478 2 20 1 1 8 1 1
34 1178 128 1 20 1 1
35 158 124 2 36 1 1 42 1 1
36 158 268 2 35 1 1 13 1 1
37 290 328 2 14 1 1 15 1 1
38 440 88 2 42 1 1 73 1 1
39 448 328 2 15 1 1 16 1 1
40 536 286 2 41 1 1 16 1 1
41 536 118 2 73 1 1 40 1 1
42 158 88 2 38 1 1 35 1 1
43 896 328 2 31 1 1 18 1 1
44 104 776 2 2 1 1 45 1 1
45 234 776 2 44 1 1 46 1 1
46 332 776 2 45 1 1 47 1 1
47 440 776 2 46 1 1 48 1 1
48 536 776 3 5 1 1 47 1 1 50 1 1
49 442 896 1 50 1 1
50 536 896 3 48 1 1 49 1 1 51 1 1
51 660 896 2 50 1 1 52 1 1
52 750 896 3 53 1 1 51 1 1 55 1 1
53 750 746 3 6 1 1 54 1 1 52 1 1
54 865 746 4 53 1 1 29 1 1 60 1 1 55 1 1
55 865 896 3 56 1 1 52 1 1 54 1 1
56 888 896 3 55 1 1 58 1 1 57 1 1
57 888 988 3 56 1 1 64 1 1 65 1 1
58 972 896 3 60 1 1 56 1 1 59 1 1
59 1178 896 2 62 1 1 58 1 1
60 972 746 3 54 1 1 7 1 1 58 1 1
61 1074 642 2 7 1 1 8 1 1
62 1178 756 2 8 1 1 59 1 1
63 56 988 2 64 1 1 1 1 1
64 146 988 2 63 1 1 57 1 1
65 1430 988 2 11 1 1 57 1 1
66 1430 54 2 11 1 1 0 1 1
67 158 54 2 0 1 1 68 1 1
68 56 54 2 67 1 1 12 1 1
69 332 540 3 4 1 1 25 1 1 70 1 1
70 448 540 3 69 1 1 26 1 1 71 1 1
71 536 540 3 70 1 1 27 1 1 5 1 1
72 668 642 2 5 1 1 6 1 1
73 536 88 3 0 1 1 41 1 1 38 1 1
74 865 480 4 31 1 1 28 1 1 32 1 1 30 1 1
75 56 496 1 113 1 1
76 326 496 4 95 1 1 113 1 1 77 1 1 81 1 1
77 570 496 4 99 1 1 107 1 1 76 1 1 108 1 1
78 844 496 4 102 1 1 92 1 1 103 1 1 105 1 1
79 1206 496 4 104 1 1 103 1 1 114 1 1 80 1 1
80 1414 496 1 79 1 1
81 326 958 2 76 1 1 82 1 1
82 570 958 2 112 1 1 81 1 1
83 844 986 1 106 1 1
84 1206 884 3 115 1 1 117 1 1 116 1 1
85 326 76 2 86 1 1 94 1 1
86 570 76 3 87 1 1 85 1 1 97 1 1
87 708 76 3 101 1 1 88 1 1 86 1 1
88 844 76 2 87 1 1 91 1 1
89 570 260 4 90 1 1 98 1 1 96 1 1 93 1 1
90 708 260 4 101 1 1 91 1 1 89 1 1 100 1 1
91 844 260 3 88 1 1 90 1 1 102 1 1
92 708 496 3 100 1 1 78 1 1 107 1 1
93 326 260 3 94 1 1 89 1 1 95 1 1
94 326 176 2 85 1 1 93 1 1
95 326 346 2 93 1 1 76 1 1
96 570 346 2 89 1 1 99 1 1
97 570 160 2 86 1 1 98 1 1
98 570 210 2 97 1 1 89 1 1
99 570 434 2 96 1 1 77 1 1
100 708 376 2 90 1 1 92 1 1
101 708 160 2 87 1 1 90 1 1
102 844 374 2 91 1 1 78 1 1
103 1018 496 2 78 1 1 79 1 1
104 1206 268 1 79 1 1
105 844 612 2 106 1 1 78 1 1
106 844 772 2 105 1 1 83 1 1
107 624 496 2 92 1 1 77 1 1
108 570 580 2 77 1 1 109 1 1
109 570 676 2 108 1 1 110 1 1
110 570 762 2 109 1 1 111 1 1
111 570 848 2 110 1 1 112 1 1
112 570 910 2 111 1 1 82 1 1
113 204 496 2 75 1 1 76 1 1
114 1206 580 2 79 1 1 115 1 1
115 1206 778 2 84 1 1 114 1 1
116 1206 938 1 84 1 1
117 1328 884 1 84 1 1
